#######################################
# Syntax Coloring Map (default)
#######################################

Packet_new	KEYWORD2
Packet_free	KEYWORD2
Packet_getType	KEYWORD2
Packet_getInterface	KEYWORD2
Packet_initialize	KEYWORD2
Packet_setType	KEYWORD2
PacketInterfaceBase	KEYWORD1
LazuriteWireless	KEYWORD1
init	KEYWORD2
begin	KEYWORD2
end	KEYWORD2
enableRx	KEYWORD2
disableRx	KEYWORD2
listen	KEYWORD2
send	KEYWORD2
sendData	KEYWORD2
sendCommand	KEYWORD2
sendCommandWithAck	KEYWORD2
sendAck	KEYWORD2
sendNotice	KEYWORD2
getAddrType	KEYWORD2
getMyAddress	KEYWORD2
setAckReq	KEYWORD2
setBroadcastEnb	KEYWORD2
setPromiscuous	KEYWORD2
setTxRetry	KEYWORD2
setSendMode	KEYWORD2
Ack	KEYWORD1
getCommand	KEYWORD2
getResponse	KEYWORD2
getResponseArray	KEYWORD2
getResponseLength	KEYWORD2
setCommand	KEYWORD2
setResponse	KEYWORD2
Command	KEYWORD1
enableAckRequest	KEYWORD2
isResponseRequested	KEYWORD2
getCommand	KEYWORD2
getCommandParam	KEYWORD2
getCommandParamLength	KEYWORD2
setCommand	KEYWORD2
setCommandParam	KEYWORD2
setResponseRequested	KEYWORD2
Data	KEYWORD1
isFragmented	KEYWORD2
getData	KEYWORD2
getDataArray	KEYWORD2
getDataSize	KEYWORD2
setData	KEYWORD2
setFragmented	KEYWORD2
resetDataSize	KEYWORD2
Notice	KEYWORD1
getNotice	KEYWORD2
getNoticeLength	KEYWORD2
setNotice	KEYWORD2
Wireless	LITERAL1
PacketType	KEYWORD1
DATA	LITERAL1
COMMAND	LITERAL1
ACK	LITERAL1
NOTICE	LITERAL1
Packet	KEYWORD1

